C 9
#########
##     ##
##     ##
## @  E #
##A@    #
## @  C #
##   #B #
##   #  #
#########

E 5
#####
#   #
#   #
#   #
#####

