A 7
#######
#     #
#     #
# D A #
#     #
#     #
#######

D 7
### ###
  #   #
#  #  #
#  E  #
##    #
#   #  
# #####

E 7
##### #
#     #
#    ##
  #   #
##  F #
#   #  
# #####

F 9
##### ###
#       #
#       #
#       #
#   @   #
         
#       #
#       #
#### ####

