A 9
#### ####
#    ####
#    ##@#
#  C    #
  A  #  #
#  E #  #
#    #@ #
#   @####
#########

E 5
#####
#   #
#   #
#   #
#####

