A 7
#######
#@    #
# D A #
#     #
# E F #
#@    #
#######

D 5
#   #
#   #
#   #
#   #
#####

E 5
#####
#####
@ @##
#####
#####

F 5
#####
#   #
#   #
#   #
#####

