A 7
#######
#@   ##
#  A ##
#     #
#EG D #
#@    #
#######

E 5
#####
#   #
#   #
#   #
#####

G 5
#####
#   #
#   #
#   #
#####

D 5
#####
#####
@ @##
#####
#####

