A 9
#########
#   @####
# #@#####
# #######
#       #
# # E F #
###  A  #
###     #
#########

E 5
##  #
##  #
##   
##  #
##  #

F 5
#####
#   #
#   #
#   #
#####

