C 11
###########
#       C##
#  ##    ##
#@ #  D A##
####E    ##
         ##
###########
###########
###########
###########
###########

A 5
#####
#   #
#   #
#   #
## ##

E 3
# #
#@#
###

