C 9
####@####
####   ##
####EA ##
####F  ##
####G   #
####  H #
####@   #
####C@C#
#########

E 5
#####
#   #
#   #
#   #
#####

F 5
#####
#   #
#   #
#   #
#####

G 5
#####
#   #
#   #
#   #
#####

H 5
#####
#   #
#   #
#   #
#####

