C 9
#########
##    @@#
##D   @@#
##E I @@#
#     A #
##G I   #
##H     #
##    I##
#########

A 5
#####
#   #
#   #
#   #
#####

E 5
#####
#   #
#   #
#   #
#####

G 5
#####
#   #
#   #
#   #
#####

H 5
#####
#   #
#   #
#   #
#####

I 5
# ###
# ###
  ###
  ###
#####

