C 7
#######
#     #
# A D #
#  #  #
#    @#
###D###
#######

A 9
#### ####
         
    #  # 
         
      #@ 
         
       # 
  E      
#### ####

E 5
#####
#   #
#   #
#   #
#####

