C 7
#######
#     #
#  D A#
#     #
###@ D#
#######
#######

A 7
#######
#  #@@#
#  ## #
      #
#E    #
#     #
#######

E 5
#####
#   #
#   #
#   #
#####

