C 9
#########
##    ###
## D D ##
##  A   #
##     ##
## ######
## ##@###
#    @###
#########

A 3
# #
 # 
# #

