C 9
#### ## #
#D#     #
# # A   #
#       #
#########
#       #
# C C C #
#       #
#########

A 3
###
 @#
###

