C 9
#########
##F   E##
##  A  ##
##     ##
##H   I##
#### ####
###G @###
#####@###
#########

F 5
#####
#   #
#   #
#   #
#####

E 5
#####
#   #
#   #
#   #
#####

A 3
   
   
   

H 3
###
  #
# #

I 5
#####
#   #
#   #
#   #
#####

G 5
#####
#   #
#   #
#   #
#####

