C 7
#######
#     #
#H    #
#G  A #
#F#   #
#E#   #
#######

H 5
#####
#   #
#   #
#   #
#####

G 5
#####
#   #
#   #
#   #
#####

A 3
   
   
   

F 5
#####
#   #
#   #
#   #
#####

E 3
###
#@#
# #

