C 7
#######
## C ##
F     D
   A   
  @@@  
       
       

F 5
#####
#   #
#   #
#   #
#####

A 5
#####
#   #
#   #
#   #
#####

