C 7
#######
#  D  #
#     #
#F A G#
#     #
#  @  #
#######

D 5
#####
#   #
#   #
#   #
#####

F 5
#####
#   #
#   #
#   #
#####

A 5
     
     
  @  
     
     

G 5
#####
#   #
#   #
#   #
#####

