C 9
#########
##     ##
##     ##
## E D ##
#   H A##
## I G ##
##     ##
##     ##
#########

E 5
#####
#   #
#   #
#   #
#####

A 3
###
 ##
###

H 7
#######
#######
#######
@@@@#@ 
#######
#######
#######

I 5
#####
#   #
#   #
#   #
#####

G 3
###
 ##
###

