C 9
#########
#       #
#  # A  #
#       #
#  D @  #
#       #
#  E @  #
#       #
#########

D 3
###
 @#
###

A 5
#####
#   #
#   #
#   #
#####

