C 9
#########
##    ###
## E  ###
##    ###
###@  ###
### #####
###  @###
###  A###
#########

A 3
###
#  
# #

