C 9
#########
#       #
#  F A  #
#       #
#  E G  #
#       #
###@@@###
### @ ###
#########

F 3
   
   
   

A 5
#####
#   #
#   #
#   #
#####

G 5
#####
#   #
#   #
#   #
#####

