C 5
#####
##E #
#   #
# A #
#####

A 7
#######
#     #
# @@@ #
#     #
#     #
#     #
# FG  #

F 5
#####
#   #
#   #
#   #
#####

G 5
#####
#   #
#   #
#   #
#####

