C 7
#######
#     #
#     #
#  A  #
#     #
###E  #
#######

A 7
#     #
#     #
#     #
#@ @ F#
#     #
#     #
#######

F 5
#####
#   #
#   #
#   #
#####

