C 6
######
###@##
#A  ##
##E @#
## ###
######

A 3
   
   
   

