C 9
#########
#########
### #####
#  A E ##
#      ##
#  G F ##
#      ##
######@@#
#########

A 3
# #
#  
###

G 5
#####
#   #
#   #
#   #
#####

F 5
#####
#   #
#   #
#   #
#####

