C 7
#######
#  @  #
#     #
#     #
# A E #
###F###
#######

E 3
###
#@#
# #

A 5
## ##
#  F#
#   #
##  #
#####

