C 7
#######
#   # #
#     #
#   #@#
#   ###
##D####
#######

D 9
# #######
#      ##
#  E  E##
#      ##
#  E A###
#      ##
#  E  G##
#      ##
#########

A 7
       
       
       
       
    ###
###@ @#
#######

G 3
# #
  #
###

