C 7
#######
# EHGF#
#     #
#  A  #
#     #
#C   @#
### ###

E 5
#####
#   #
#   #
#   #
#####

H 5
#####
#   #
#   #
#   #
#####

G 5
#####
#   #
#   #
#   #
#####

F 3
###
###
#@#

A 3
###
#  
# #

