A 7
#######
#@#   #
#  D  #
#  @A #
# E C #
#    @#
### ###



