C 7
#######
#A   ##
#    ##
#/?D F  #
#    G#
### GG#
#######

A 5
     
 #   
  #@ 
@##  
##   

F 5
#####
#   #
#   #
#   #
#####

G 5
## ##
#####
 ####
#####
#####

