C 9
#########
##  @  ##
#?D  A  ##
##      #
#?G I J I#
##     ##
##     ##
####J####
#########

A 5
    #
    #
    #
E    
@   #

E 5
#####
#   #
#   #
#   #
#####

G 5
    #
    #
    #
H    
@   #

H 5
#####
#   #
#   #
#   #
#####

I 3
# #
###
###

J 3
# #
###
###

