C 9
#########
###!H I#!E#
###  ## #
#I # GD #
#H  ### #
#E# !I#I #
#I#  ##@#
#A#@ ##@#
#########

G 5
#####
#   #
#   #
#   #
#####

A 5
#####
#   #
#   #
#   #
#####

H 5
     
     
     
  #  
   # 

E 5
     
     
     
  #  
   # 

I 5
     
     
     
  #  
   # 

