C 9
#########
###?D#####
#       #
#  A J  #
#  G E  #
#  G H  #
#       #
#####  I#
#########

D 5
#####
#####
#### 
##   
## ##

A 5
#####
#   #
#   #
#   #
#####

E 5
#####
#   #
#   #
#   #
#####

G 5
#####
#####
##   
#####
#####

H 5
#####
#   #
#   #
#   #
#####

I 3
###
#@#
# #

