C 9
#########
#########
###     #
#?F# @ D #
###     #
### A D #
##      #
#########
#########

F 7
## G   
#D     
   @   
H  @  I
   @   
       
   J   

G 5
#####
#   #
#   #
#   #
#####

H 5
#####
#   #
#   #
#   #
#####

I 5
#####
#   #
#   #
#   #
#####

A 5
#####
#   #
#   #
#   #
#####

D 3
   
 # 
   

