C 9
#########
##    ###
#      F#
# #@  ###
#     D##
# A@  ###
#     #D#
##   ####
#########

F 5
     
     
     
     
     

A 3
###
 E@
###

E 5
#####
#   #
#   #
#   #
#####

