C 7
#######
#  D  #
#  @  #
#E @@A#
#  @  #
#  G  #
#######

D 5
#####
#   #
#   #
#   #
#####

E 5
    #
     
     
     
     

A 5
     
     
     
     
    #

