C 13
#############
##       ####
##   @   ####
##       # ##
##       #F##
##       #K##
##       #J##
##       #I##
##       #G##
##       ####
## A /A A ####
##       ####
#############

F 5
#####
#   #
#   #
#   #
#####

K 3
## 
##J
###

J 3
## 
##I
###

I 3
## 
##G
###

G 3
##A
###
###

A 5
     
     
  #  
     
     

