C 9
#########
#####   #
#####   #
##### G #
 AEC#   #
##    F #
##      #
   #    #
#########

A 5
#####
#   #
#   #
#   #
#####

E 3
###
#@#
# #

F 5
#####
#   #
#   #
#   #
#####

