C 7
#######
#    ##
#  A @#
#    @#
#  /A ##
#    ##
#######

A 5
     
     
  F  
     
     

F 5
#####
#   #
#   #
#   #
#####

