A 5
#####
#####
##D##
## ##
#####

D 9
     # ##
     A ##
     A ##
     A ##
###  A ##
  #  #@##
  #  #@##
     #@##
######@##

