C 9
#########
##M######
#P I#####
##K######
####A  ##
#### #@##
#### ####
#A /A A A#
#########

M 3
###
# #
#N#

N 3
###
###
##A

P 3
###
# Q
###

Q 5
#####
#   #
#   #
#   #
#####

I 3
###
J #
###

J 5
#####
#   #
#   #
#   #
#####

K 3
#L#
# #
###

L 5
#####
#   #
#   #
#   #
#####

A 3
#@#
###
# #

