C 9
#########
#@      #
#   E A #
#       #
  #    C#
#       #
####### #
######@ #
#########

A 5
#####
#   #
#   #
#   #
#####

