C 9
#########
## D#####
#    E  #
#       #
#@ @A@  #
#       #
#  H    #
#####G ##
#########

D 5
#####
#####
  ###
# ###
# ###

A 5
#####
#   #
#   #
#   #
#####

H 5
#####
#   #
#   #
#   #
#####

G 5
## ##
##   
#####
#####
#####

