C 9
#########
#########
##  E  ##
#       #
#   @   #
#       #
# @ A   #
#########
#########

A 5
  F  
     
     
     
     

F 5
     
     
     
     
     

