C 7
#######
#     #
#  A  #
#     #
# F E #
#     #
#######

F 7
###@###
#######
#@@   #
##H##  
##G####
##  ###
### ###

H 5
#####
#   #
#   #
#   #
#####

G 5
#####
#   #
#   #
#   #
#####

A 5
     
     
     
     
     

