C 9
#########
#       #
# E F A #
#       #
#########
#       #
# @   @ #
#   E   #
#########

F 5
#####
#   #
#   #
#   #
#####

A 5
## ##
#   #
  #  
#   #
## ##

