C 9
#########
#  G E  #
#I   @  #
#    @ E#
# A E@  #
#    @  #
#   #@ F#
# H     #
#########

G 5
#####
#   #
#   #
#   #
#####

I 5
#####
#   #
#   #
#   #
#####

A 1
 

F 5
#####
#   #
#   #
#   #
#####

H 5
#####
#   #
#   #
#   #
#####

