C 7
#######
#     #
# D E #
#A   ##
# G H #
#     #
#######

D 5
#####
    #
    #
    #
#####

E 5
#####
#   #
#   #
#   #
#####

G 5
#####
###@ 
#####
#####
#####

A 5
#####
#   #
#   #
#   #
#####

