C 9
#########
# I# G D#
#       #
#      F#
##A# J  #
## ######
#    ####
# HH #?E@#
#########

I 5
#####
#   #
#   #
#   #
#####

G 5
#####
#   #
#   #
#   #
#####

D 5
#####
#   #
#   #
#   #
#####

F 5
#####
#   #
#   #
#   #
#####

A 7
       
       
       
   #   
       
       
       

J 5
#####
#   #
#   #
#   #
#####

E 3
   
   
   

