C 9
#########
#E  ###@#
#@####  #
# H #  G#
##    # #
####### #
## A  # #
##      #
#########

E 5
#####
#   #
#   #
#   #
#####

H 5
#####
#   #
#   #
#   #
#####

G 5
#####
#   #
#   #
#   #
#####

A 5
## ##
#####
 ### 
#####
## ##

F 5
#####
#   #
#   #
#   #
#####

