C 5
#####
#E#D#
#   #
# A #
#####

E 5
#####
#   #
#   #
#   #
#####

A 5
     
     
  @@ 
     
     

