A 11
###########
#         #
#   C      
#   !A     #
#   !!C     #
#   !!!C     #
#   !!!!C   #  
#       ## 
########## 
###!!!!!C @#### 
###########

