C 5
#####
##D##
##A##
#####
#####

A 7
#######
#######
#######
#######
#######
#######
  E BB 

E 5
#####
#@ @#
#@  #
#   #
## ##

