A 11
###########
#         #
#  !!A       
#  !!!C      #
#  !!!!C      #
#     ## ##
#   C!C## # 
#     #  # 
####### ## 
##!!!!!C @##    
###########

