C 9
#########
#F  #   #
#E#   A #
#       #
###   @ #
######@##
###### ##
######@##
#########

F 5
#####
#   #
#   #
#   #
#####

A 5
#####
#   #
#   #
#   #
#####

