C 7
#######
#@@  ##
#  D ##
#     #
#     #
###E###
#######

D 5
     
     
     
     
     

A 5
#####
#   #
#   #
#   #
#####

