C 7
#######
#     #
# E # #
#  @  #
# D # #
#     #
#######

A 5
#####
#   #
#   #
#   #
#####

D 5
     
     
     
     
     

