C 7
#######
###@###
### ###
#@ D @#
### ###
###@###
#######

D 5
     
 E F 
  @  
 A H 
     

A 5
#####
#   #
#   #
#   #
#####

F 5
#####
#   #
#   #
#   #
#####

H 5
#####
#   #
#   #
#   #
#####

