C 9
#### ####
####    #
#    A  #
# ##    #
  @#   E#
#@####  #
##   #  #
##     C#
#########

A 5
#####
#   #
#   #
#   #
#####

