C 9
####E####
#       #
#       #
#C A    #
        #
#    ####
#    C###
#@@@ ####
#########

A 5
#####
#   #
#   #
#   #
#####

