A 11
###########
##### #####
##### E  ##
### #    ##
###  A   ##
### #######
### ##@####
##       ##
## # #  ###
##  @######
###########

E 3
# #
#  
# #

