A 9
#########
#      @#
# #D#   #
#       #
#      !#
#####A ##
#  C@#  #
#      ##
#########

