C 9
#########
###@  #@#
#D#     #
#      ##
#    A   
# #     #
#  #    #
##C#  #D#
#### ####

A 5
     
     
     
     
#####

