C 7
#######
##@#A##
#     #
##@# ##
#     #
## #D##
#######

A 3
   
   
   

