A 11
###########
##### #####
##### #####
####@@#####
##### #####
###     ###
### F D ###
###     ###
### G A ###
###     ###
###########

F 5
  #  
     
     
     
     

D 5
     
     
     
     
    #

G 5
     
     
     
     
     

