C 7
#######
#     #
# E D #
#     #
# A G #
#     #
#######

E 3
   
   
   

A 9
#########
#########
#########
#########
#########
#########
#########
##@######
## ######

G 3
   
   
   

