C 7
#######
#     #
#G    #
#  A F#
#     #
#I H D#
#######

G 5
#####
#   #
#   #
#   #
#####

A 5
     
   @ 
  #  
     
     

F 5
#####
#   #
#   #
#   #
#####

I 5
#####
#   #
#   #
#   #
#####

H 5
#####
#   #
#   #
#   #
#####

D 5
     
     
  #  
     
     

