C 9
#########
##      #
## A E  #
##   F  #
## G H  #
## @ I  #
#@ # K  #
####   @#
#########

A 5
#####
#   #
#   #
#   #
#####

E 5
#####
#   #
#   #
#   #
#####

F 5
#####
#   #
#   #
#   #
#####

G 5
     
     
     
     
     

H 5
#####
#   #
#   #
#   #
#####

I 5
#####
#   #
#   #
#   #
#####

J 5
#####
#   #
#   #
#   #
#####

K 5
#####
#   #
#   #
#   #
#####

