C 9
#########
#   #  ##
# A #  ##
#   #  ##
#   ## ##
#     E##
#@#@  F##
#########
#########

A 5
#####
#   #
#   #
#   #
#####

F 7
### ###
### ###
### ###
      #
#     #
#######
#######

