C 9
#########
#     ###
#     ###
# A F #@#
#      @#
# E G #@#
#     ###
#     ###
#########

F 5
#####
#   #
#   #
#   #
#####

A 5
#####
     
  @  
     
     

G 5
#####
#   #
#   #
#   #
#####

