C 7
#######
#     #
# D A #
#     #
# E E #
#     #
#######

D 5
#####
#####
#####
###@#
### #

A 5
##  #
#####
#####
#####
#####

