C 7
#######
#     #
#   A #
#     #
###   #
###E  #
#######

E 7
# #   #
# #   #
#@#   #
### F #
###   #
#######
#######

A 7
#######
#     #
#     #
#      
#     #
#     #
#     #

