C 7
#######
#     #
#  DE #
##   A#
## GH #
##    #
#######

D 9
#### ####
#########
#     ###
#     ###
#     ###
#     ###
#     ###
#     #@#
#   # # #

A 9
#### ####
#########
#       #
#       #
#       #
#       #
#       #
#       #
# #     #

G 9
##  #  ##
#       #
#       #
#       #
#       #
#       #
#       #
#########
#### ####

H 9
### #   #
#       #
#       #
#       #
#       #
#       #
#       #
#########
#### ####

