C 9
#########
#       #
#       #
#  G A  #
#  GFE  #
#  GFE  #
#       #
#       #
#########

G 7
# #####
#      
#######
#####  
##### #
#@###  
# #####

F 7
# #####
# #####
# #####
# #####
# #####
# #####
# #####

A 7
#######
  #####
# #####
# #####
# #####
  #####
#######

