C 9
#########
##@######
# A #####
  #     #
 ## @E@ #
###     #
### C F@#
##### ###
#########

E 5
#####
#   #
#   #
#   #
#   #

A 5
#####
#   #
#   #
#   #
#####

