C 7
#######
#     #
#    C 
#A    #
#     #
# FEGIH
######@

A 5
#####
#   #
#   #
#   #
#####

E 5
#####
#   #
#   #
#   #
#####

G 3
###
#  
###

I 5
#####
#   #
#   #
#   #
#####

H 5
#####
#   #
#   #
#   #
#####

